21 21 21 21 21 21 21 21 21 21 22 21 21 21 21 21 21 21 21 21 21 21 21 21 21 21 21 21 21 21 21 21 22 21 22 21 21 21 21 21 21 21 21 21 21 21 21 21 21 21 
21 21 21 21 21 22 21 21 21 21 21 21 21 21 21 22 21 21 21 21 21 21 21 21 21 21 21 21 21 21 21 21 21 21 21 21 21 21 21 21 21 21 21 21 22 21 21 22 21 21 
21 21 21 21 21 21 21 22 21 22 22 21 22 21 21 21 21 21 22 21 21 22 21 21 22 22 21 21 21 22 21 21 22 21 21 22 21 22 22 21 21 22 22 21 21 21 21 21 21 21 
21 21 21 21 21 21 21 21 22 21 21 21 21 21 22 21 21 21 21 21 21 21 21 21 21 21 21 21 21 21 21 21 21 21 21 22 21 21 21 21 21 21 22 22 21 21 22 21 21 21 
21 21 21 21 21 21 21 21 21 21 21 21 21 21 21 22 21 21 21 21 21 21 21 21 21 21 21 21 21 21 22 21 21 21 21 21 21 21 21 21 21 21 21 21 21 21 21 22 21 21 
21 21 21 21 22 21 31 29 29 29 29 29 29 29 29 32 21 31 29 29 29 29 29 29 29 29 29 29 29 32 21 21 21 21 31 29 29 29 29 29 29 29 29 29 32 21 21 21 21 21 
21 21 21 21 22 21 27 19 20 20 20 20 20 19 19 28 29 30 19 3 2 2 2 3 2 3 2 2 2 28 32 21 21 21 27 19 3 14 12 12 12 12 12 15 26 21 21 22 22 21 
21 21 21 21 21 21 27 19 20 0 0 0 20 19 19 19 19 19 19 2 23 24 24 24 24 24 25 2 19 19 28 29 29 29 30 19 19 10 5 5 5 5 5 9 26 21 21 22 21 21 
21 21 21 21 21 21 27 19 20 0 0 0 20 19 19 19 19 19 19 2 26 21 21 21 22 21 27 2 19 19 19 19 19 19 19 19 19 10 5 5 5 5 5 9 26 21 21 21 21 21 
21 22 21 21 21 21 27 19 20 0 0 0 20 19 19 19 19 19 19 2 26 21 22 21 21 21 27 2 19 19 19 19 19 19 19 19 19 10 5 5 5 5 5 9 26 21 21 21 21 21 
21 22 21 22 21 21 27 19 20 0 0 0 20 19 19 19 19 19 19 2 26 21 21 21 22 21 27 2 19 19 19 19 19 19 19 19 19 10 5 5 5 5 5 9 26 21 21 22 21 21 
22 21 21 22 21 21 27 19 20 0 0 0 20 19 19 19 19 19 19 2 26 22 21 21 21 22 27 2 19 19 19 19 19 19 19 19 19 10 5 5 5 5 5 9 26 21 21 21 21 22 
21 21 21 21 21 21 27 19 20 20 0 20 20 19 19 19 19 19 19 2 28 29 29 29 29 29 30 2 19 19 19 19 19 19 19 19 19 10 5 5 5 5 5 9 26 21 22 21 22 22 
21 21 21 21 21 21 27 19 19 19 2 19 19 19 19 19 19 19 19 2 3 2 14 12 15 3 2 2 2 2 2 2 2 2 2 2 3 10 5 5 5 5 5 9 26 21 22 22 21 21 
21 21 21 21 21 22 33 24 25 19 2 19 19 19 19 19 19 19 19 19 19 19 10 5 9 19 19 19 19 19 19 19 19 19 19 19 19 16 7 8 5 6 7 17 26 21 21 21 21 21 
21 22 21 22 21 21 21 22 27 19 2 19 19 19 19 19 19 19 19 19 19 19 10 5 9 19 19 19 19 19 19 19 19 19 19 19 19 19 19 10 5 9 23 24 34 21 21 21 22 21 
21 21 22 22 21 22 21 31 30 19 2 19 19 19 19 19 19 19 19 19 19 19 10 5 9 19 19 19 19 19 19 19 19 19 19 19 19 19 19 10 5 9 26 21 21 21 21 21 22 21 
21 21 21 21 21 21 31 30 19 19 2 19 19 19 19 19 19 19 19 19 19 19 10 5 9 2 2 2 19 19 19 19 19 19 19 19 19 19 19 10 5 9 26 21 21 21 21 21 21 21 
21 21 21 21 21 21 27 19 19 19 2 19 19 19 19 19 19 19 19 19 19 19 10 5 9 19 19 19 19 19 19 19 19 19 19 19 19 19 19 10 5 9 26 21 21 21 22 22 21 21 
21 21 21 21 21 22 27 19 19 2 2 19 19 19 19 19 19 19 19 19 19 19 10 5 9 19 19 19 19 19 19 19 19 19 19 19 19 19 19 10 5 9 26 21 21 22 22 21 21 21 
21 21 21 21 21 21 27 19 19 2 19 19 19 19 19 19 19 19 19 19 19 19 10 5 9 19 19 19 19 19 19 19 19 19 19 19 19 19 19 10 5 9 26 21 21 21 21 22 22 21 
21 21 21 21 21 21 27 19 19 2 19 19 19 19 19 19 19 19 19 19 19 19 10 5 9 19 19 19 19 19 19 19 19 19 19 19 19 14 12 13 5 9 26 21 21 21 21 21 21 21 
21 21 21 22 21 21 33 25 19 2 19 19 19 19 19 19 19 19 19 19 19 19 10 5 9 19 19 19 19 19 19 19 19 19 19 19 19 10 5 5 5 9 26 21 22 21 21 21 21 22 
21 21 21 22 21 21 21 27 19 2 19 19 19 19 19 19 19 19 19 19 19 2 10 5 9 2 19 19 19 19 19 19 19 19 19 19 19 10 5 6 7 17 26 21 21 21 21 21 21 22 
21 22 21 21 21 21 21 27 19 2 19 19 2 2 14 12 12 12 12 12 12 12 13 5 11 12 12 12 12 12 15 19 19 19 19 14 12 13 5 9 2 19 26 21 21 21 21 21 21 21 
21 22 21 21 22 21 31 30 19 2 19 19 2 3 10 5 5 5 5 5 5 5 5 5 5 5 5 5 5 5 9 3 2 2 2 10 5 5 5 9 2 23 34 21 21 21 21 21 21 21 
21 21 21 21 21 21 27 19 19 2 19 19 3 2 16 7 7 7 7 7 7 7 8 5 6 7 7 7 7 7 17 19 19 19 19 16 7 8 5 9 2 26 21 21 21 21 22 21 21 21 
21 21 22 21 21 21 27 19 19 2 19 19 2 19 19 19 19 19 19 19 19 3 10 5 9 19 19 19 19 19 19 19 19 19 19 19 3 10 5 9 3 26 21 21 21 21 21 21 21 21 
21 21 21 21 21 21 27 19 19 2 19 19 2 2 19 19 19 19 19 19 19 19 10 5 9 19 19 19 19 19 19 19 19 19 19 19 19 10 5 9 2 26 21 22 21 21 21 21 22 21 
21 21 21 21 22 21 33 25 19 2 19 19 19 2 19 19 19 19 19 19 19 19 10 5 9 19 19 19 19 19 19 19 19 19 19 19 19 10 5 9 2 26 21 21 21 21 21 21 21 21 
21 21 21 21 21 21 21 27 19 2 19 19 19 2 19 19 19 19 19 19 19 19 10 5 9 2 2 2 19 19 19 19 19 19 19 19 19 10 5 9 2 26 21 21 21 21 21 21 21 21 
21 21 21 21 21 21 21 27 19 2 2 2 2 2 2 2 19 19 19 19 19 19 10 5 9 19 19 2 19 19 19 19 19 19 19 19 19 16 7 17 19 26 21 21 21 21 21 21 21 21 
21 21 21 21 21 21 21 27 19 2 2 2 2 2 2 2 19 19 19 19 19 19 10 5 9 19 19 2 19 19 2 19 19 19 19 19 19 19 2 2 23 34 21 21 21 21 21 21 21 21 
21 21 22 21 21 21 21 27 19 2 2 3 2 2 2 2 19 19 19 19 19 19 10 5 9 19 19 2 19 19 2 19 19 19 19 19 19 19 2 2 26 21 21 21 21 21 21 21 21 21 
21 21 22 21 21 21 21 27 19 2 2 2 2 3 2 2 19 19 19 19 19 19 10 5 9 19 19 2 2 2 2 19 19 19 19 19 19 2 2 2 26 21 21 21 21 21 21 22 21 21 
21 21 21 21 21 21 22 27 19 2 2 3 2 2 3 2 19 19 19 19 19 19 10 5 9 19 19 19 19 19 19 19 19 19 19 19 19 2 3 2 26 21 21 22 21 21 21 21 21 21 
21 21 21 21 22 21 31 30 19 2 2 2 2 2 2 2 19 19 19 19 2 2 16 7 17 2 2 19 19 19 19 19 19 19 19 19 2 3 2 2 26 21 21 21 21 21 21 21 21 21 
22 21 21 21 21 21 27 19 19 19 19 19 19 19 19 19 19 19 19 2 2 2 3 2 2 2 2 2 19 19 19 19 19 19 19 2 2 2 2 2 28 32 21 21 21 22 21 21 21 21 
22 22 21 21 21 21 27 19 19 19 19 19 19 19 19 19 19 19 2 2 3 2 2 2 2 2 2 2 2 19 19 19 19 19 19 2 2 19 2 2 2 28 32 21 21 21 21 22 21 21 
21 22 21 21 21 21 27 19 19 19 19 19 19 19 19 19 19 19 2 2 2 2 2 2 2 3 2 2 2 19 19 19 19 2 3 2 2 2 2 2 2 2 26 21 21 21 21 21 21 21 
21 22 21 21 22 21 27 19 19 4 19 19 19 19 19 19 19 19 2 2 2 3 3 2 2 3 2 2 2 19 19 19 2 2 2 2 2 2 19 2 2 2 26 21 21 21 21 21 21 21 
21 22 21 21 21 21 27 19 19 2 19 19 2 2 2 2 2 2 2 2 2 2 2 2 2 3 2 3 2 2 2 2 2 2 2 3 19 2 2 2 2 2 26 21 21 21 21 22 21 21 
21 21 21 21 21 21 27 19 19 2 2 2 2 19 23 24 25 2 2 2 2 3 2 2 2 2 2 2 2 23 24 24 25 2 2 2 2 2 3 2 19 2 26 21 21 21 21 22 21 21 
21 21 22 21 21 21 27 19 19 19 19 19 19 23 34 21 33 25 2 2 2 2 2 2 2 2 2 2 2 26 21 21 33 25 2 2 2 2 2 2 2 23 34 21 22 21 22 21 21 21 
21 21 22 21 21 21 33 24 24 24 24 24 24 34 21 21 21 33 24 24 24 24 24 24 24 24 24 24 24 34 21 21 21 33 24 24 24 24 24 24 24 34 21 21 21 21 22 21 21 21 
21 21 21 21 21 21 21 21 21 21 21 22 21 22 21 21 21 21 21 21 21 21 21 21 21 21 21 21 21 21 21 21 21 21 21 21 21 22 21 21 21 21 21 21 21 21 22 22 22 21 
21 21 22 22 21 21 21 21 21 21 21 21 21 21 21 21 21 21 21 21 22 22 22 22 21 21 21 21 21 21 22 21 21 21 21 21 21 22 22 21 21 21 21 21 21 21 21 21 22 21 
21 21 21 21 21 21 21 21 22 21 21 21 21 21 21 22 22 22 21 21 21 21 21 21 22 21 21 21 21 21 21 21 21 21 21 21 21 22 21 21 21 21 21 21 21 21 21 21 22 22 
21 21 21 21 21 21 21 21 21 21 21 21 21 21 21 21 21 21 21 21 21 21 21 21 21 22 21 21 21 21 21 21 21 21 21 21 21 21 21 21 21 21 21 22 21 21 21 21 21 21 
21 21 21 21 21 21 21 21 21 21 21 21 21 21 21 21 22 21 21 21 21 21 21 21 21 22 22 21 21 21 21 21 21 21 21 21 21 21 21 21 21 21 21 21 21 21 21 21 21 21 
