21 21 21 22 21 21 21 21 21 21 21 21 22 22 21 21 21 21 21 22 21 21 21 21 22 21 21 21 21 22 21 21 21 21 21 22 21 21 21 21 21 21 21 21 21 21 21 21 21 21 
21 21 21 31 29 29 29 29 29 29 29 29 29 29 29 29 29 29 29 29 29 29 29 29 29 29 29 29 29 29 29 29 29 29 29 29 32 21 21 21 21 22 21 21 21 21 21 21 22 21 
21 21 21 27 2 2 2 2 2 2 2 2 2 2 2 2 2 2 2 2 2 2 2 19 19 19 2 2 2 2 19 2 2 2 2 2 26 21 22 21 21 21 21 21 21 21 21 21 21 21 
21 21 21 27 2 20 20 20 20 20 20 20 20 20 2 2 2 2 2 2 2 2 2 19 19 19 19 2 2 19 19 19 19 19 19 19 28 29 29 29 29 29 29 29 29 29 29 29 32 21 
21 22 21 27 2 20 1 1 1 1 1 1 1 20 2 2 2 2 19 2 2 3 2 2 19 19 19 3 3 19 19 19 19 19 19 19 19 19 19 19 19 2 2 2 2 2 2 2 26 21 
21 21 21 27 2 20 1 1 1 1 1 1 1 20 2 19 2 3 19 19 2 2 2 19 19 19 2 2 2 19 19 23 24 24 24 24 25 19 19 19 19 2 2 19 19 2 2 2 26 21 
21 21 21 27 2 20 1 1 1 18 1 1 1 20 2 19 3 3 19 19 19 19 19 19 2 19 19 2 3 19 19 26 22 21 21 21 33 24 25 19 19 19 19 19 19 19 19 2 26 22 
21 22 21 27 2 20 1 1 1 1 1 1 1 20 2 19 3 2 19 19 2 2 2 2 2 19 2 2 3 19 19 26 21 22 31 32 22 21 27 19 19 19 19 19 19 19 19 2 26 21 
21 21 21 27 2 20 1 1 1 1 1 1 1 20 2 19 2 2 2 19 3 3 3 19 19 19 2 2 2 19 19 26 21 22 33 34 21 21 27 19 19 19 19 19 19 19 19 19 26 21 
22 21 21 27 2 20 20 20 20 5 20 20 20 20 2 19 2 19 19 2 19 19 19 19 2 2 2 2 2 19 19 28 29 29 29 29 29 29 30 19 19 19 19 19 19 19 19 2 26 21 
22 22 21 27 2 2 2 2 10 5 9 2 2 2 2 19 2 19 2 19 19 2 2 2 2 2 2 2 2 19 19 19 19 14 12 15 19 19 19 19 19 2 3 19 19 19 19 2 26 21 
21 21 21 27 2 2 19 2 10 5 9 2 19 2 2 19 19 2 2 2 2 2 2 2 14 12 12 12 12 12 12 12 12 13 5 9 2 2 2 2 2 2 19 19 2 2 2 2 26 21 
21 21 21 27 2 19 19 2 10 5 9 19 19 2 2 2 19 19 2 2 2 2 2 19 10 5 5 5 5 5 5 5 5 5 5 9 2 2 2 19 19 19 19 2 2 2 2 2 26 21 
21 21 21 27 2 19 19 2 10 5 9 2 19 2 3 3 2 2 2 19 19 19 2 19 10 5 6 7 7 7 7 7 7 7 7 17 2 2 2 19 2 2 2 14 12 12 12 12 26 22 
21 22 21 27 2 2 19 2 10 5 9 2 2 2 2 2 2 3 3 19 19 19 19 19 10 5 9 19 19 19 19 2 2 2 2 2 19 19 19 2 14 12 12 13 5 5 5 5 26 21 
21 22 21 27 2 2 19 2 10 5 9 2 2 3 3 3 3 3 2 19 19 2 19 19 10 5 9 19 19 19 19 19 19 2 2 2 19 2 2 2 10 5 5 5 5 6 7 7 26 21 
21 21 21 27 2 2 19 2 10 5 9 2 2 2 2 2 2 2 2 19 19 19 19 19 10 5 9 19 2 19 19 19 19 19 19 19 19 19 19 2 10 5 6 7 7 17 2 2 26 22 
21 21 21 27 2 2 2 2 13 5 9 2 19 19 19 19 2 2 2 19 19 19 19 19 10 5 9 19 19 19 19 19 19 19 19 19 19 19 2 2 10 5 9 2 2 2 2 2 26 22 
21 31 29 30 2 19 2 10 5 5 9 2 2 2 19 19 2 2 2 19 19 2 19 19 10 5 9 19 19 19 19 19 19 3 19 19 2 2 2 2 10 5 9 2 2 2 2 2 26 22 
21 27 2 2 2 19 2 10 5 6 2 2 19 19 19 19 19 2 2 2 2 2 2 19 10 5 9 19 19 19 19 19 3 3 19 19 2 2 2 2 10 5 9 2 2 2 2 2 26 21 
21 27 2 2 2 19 2 10 5 9 2 19 19 2 2 2 2 2 19 19 2 2 2 19 10 5 9 19 19 19 19 19 2 19 19 2 2 2 2 2 10 5 9 2 2 2 2 2 26 21 
22 27 2 2 3 19 2 10 5 9 19 19 2 2 3 3 3 3 19 19 19 19 2 19 10 5 9 2 2 2 2 19 19 2 2 2 2 2 2 2 10 5 9 2 2 2 2 2 26 21 
22 27 2 3 2 19 2 10 5 9 2 2 2 2 3 19 19 3 19 19 3 3 3 2 10 5 9 2 2 2 2 2 2 2 2 2 2 2 2 2 10 5 9 2 2 2 2 23 34 21 
21 27 2 3 2 3 2 10 5 9 2 2 19 19 19 19 19 19 19 19 19 2 2 2 10 5 9 2 2 2 2 2 2 2 2 2 2 2 2 2 10 5 9 2 2 2 2 26 21 21 
22 27 2 3 2 3 2 10 5 9 2 2 2 2 14 12 12 12 12 12 12 12 12 12 13 5 11 12 12 12 12 12 12 12 12 12 12 12 12 12 13 5 9 2 2 2 2 26 22 21 
22 27 2 3 4 2 2 10 5 9 2 2 2 2 10 5 5 5 5 5 5 5 5 5 5 5 5 5 5 5 5 5 5 5 5 5 5 5 5 5 5 5 9 2 3 2 2 26 21 21 
21 27 2 2 2 2 3 10 5 9 2 19 19 19 16 7 7 7 7 7 7 7 7 7 8 5 6 7 7 7 7 7 7 7 7 7 7 7 7 7 7 7 17 3 3 2 2 26 21 21 
21 27 2 3 19 3 3 10 5 11 15 2 19 19 19 19 19 2 3 2 2 2 2 2 10 5 9 2 19 19 19 19 2 19 2 2 2 2 2 2 2 2 2 3 2 2 2 26 21 21 
21 27 2 2 3 3 2 10 5 5 9 2 2 3 2 2 3 3 19 2 19 19 19 19 10 5 9 2 19 19 19 19 19 19 19 19 19 19 19 2 19 19 19 19 3 2 2 26 22 21 
21 27 2 2 19 3 2 16 8 5 9 2 2 3 2 3 3 19 19 2 19 19 2 19 10 5 9 2 19 2 19 19 19 19 19 19 19 19 19 19 19 19 19 19 19 19 2 26 21 21 
21 27 2 2 2 2 2 2 10 5 11 15 2 3 3 19 19 19 19 2 2 2 2 19 10 5 9 2 19 19 19 19 19 19 19 19 19 19 19 19 2 19 19 19 19 2 2 26 21 21 
21 27 2 2 2 3 2 2 10 5 5 9 2 2 3 19 2 19 19 19 2 2 2 19 10 5 9 2 2 3 19 19 19 19 19 19 19 19 19 19 19 19 2 19 2 2 2 26 21 21 
22 27 2 2 2 2 2 14 13 5 5 9 2 2 3 2 19 19 19 19 19 2 19 14 13 5 9 2 2 19 19 19 19 19 19 19 19 19 19 19 19 2 19 19 2 2 2 26 21 21 
21 27 14 12 12 12 12 13 5 5 5 9 2 2 19 19 19 19 19 19 19 2 19 10 5 5 9 2 2 19 19 19 19 19 19 19 19 19 19 19 19 19 2 3 2 2 2 26 22 21 
21 27 10 5 5 5 5 5 5 6 7 2 19 19 2 19 19 19 19 19 2 2 19 10 5 6 17 2 2 2 19 19 19 19 19 19 19 19 19 19 19 2 3 3 2 2 2 26 21 21 
21 27 16 8 5 5 6 7 7 17 19 19 19 19 19 19 19 19 19 19 2 2 19 10 5 11 15 2 2 2 19 19 19 19 19 19 19 19 19 19 2 2 2 2 2 2 2 26 21 22 
22 27 2 10 5 5 9 19 19 19 19 3 2 3 2 19 19 19 2 19 2 2 19 10 5 5 11 15 2 2 19 19 19 19 19 19 19 19 19 2 19 2 2 2 2 2 2 26 21 22 
21 33 25 16 8 5 11 15 19 2 2 2 3 3 2 2 2 2 2 19 3 2 2 16 8 5 5 11 15 2 2 2 2 2 19 19 19 19 19 19 19 2 23 24 24 24 24 34 21 22 
21 21 27 2 10 5 5 9 19 2 2 2 2 2 2 2 2 3 2 2 3 3 2 2 16 8 5 5 11 15 2 2 2 2 2 2 19 19 2 19 19 2 26 21 21 21 21 21 21 21 
21 21 27 2 16 8 5 11 15 19 2 2 3 2 2 2 2 2 2 2 2 2 3 3 2 16 8 5 5 11 12 12 12 15 3 2 19 19 19 19 19 2 26 21 21 21 21 21 21 21 
22 21 27 2 2 10 5 5 11 15 19 19 19 19 19 19 19 19 2 3 2 19 19 3 19 19 16 7 8 5 5 5 5 11 15 2 19 19 19 19 19 2 26 21 22 21 21 21 21 21 
22 21 27 2 2 16 8 5 5 11 12 12 12 12 12 12 15 19 2 3 2 19 19 19 19 19 19 19 16 7 7 8 5 5 9 2 19 19 2 19 19 2 26 21 21 21 21 21 21 22 
21 21 27 2 2 2 16 8 5 5 5 5 5 5 5 5 9 19 19 19 19 19 19 19 19 19 19 19 19 19 14 13 5 6 17 2 19 2 2 2 2 2 26 21 21 21 21 21 21 21 
21 21 27 2 2 2 2 16 7 7 7 7 7 7 8 5 11 12 12 12 12 12 12 15 19 19 19 19 14 12 13 5 5 9 2 2 2 23 24 24 24 24 34 21 21 21 21 21 21 21 
21 21 33 24 25 2 2 2 19 19 19 19 2 2 10 5 5 5 5 5 5 5 5 11 12 12 12 12 13 5 5 5 6 17 3 2 2 26 21 21 21 21 21 21 21 22 21 21 21 21 
21 21 21 22 27 2 3 2 3 19 19 2 2 2 16 7 7 7 7 7 7 8 5 5 5 5 5 5 5 5 6 7 17 2 2 3 2 26 21 21 21 21 22 22 22 22 21 21 21 21 
21 21 22 21 27 2 2 2 2 2 19 3 3 3 3 2 2 3 3 19 2 16 7 7 7 7 7 7 7 7 17 2 3 3 2 3 2 26 22 21 21 21 22 21 21 22 21 21 21 21 
21 21 21 21 27 2 2 2 2 2 2 2 2 2 2 2 2 2 2 2 2 2 2 2 2 2 2 2 2 2 2 2 2 2 2 2 2 26 21 21 21 21 21 21 21 21 21 21 21 21 
21 21 21 21 33 24 24 24 24 24 24 24 24 24 24 24 24 24 24 24 24 24 24 24 24 24 24 24 24 24 24 24 24 24 24 24 24 34 21 21 21 21 21 21 21 21 21 21 21 21 
22 21 21 22 21 22 21 21 21 21 21 22 22 22 21 21 21 21 21 22 21 21 21 21 21 21 21 22 21 21 21 21 21 21 21 21 21 21 22 22 21 21 21 21 21 21 21 21 22 22 
